20 20
WWWWWWWWWWWWWWWWWWWW
W..................W
W..................W
W..U...............W
W...........D......W
WWWWWW.............W
W.....P............W
W..................W
W...........WWWWWWWW
W..................W
W.........U........W
W..................W
W..U...............W
W..................W
W.....W............W
W.....W............W
W.....W............W
W.....W............W
W.....W............W
WWWWWWWWWWWWWWWWWWWW