WWWWWWWWWWWWWWWW
W..............W
W..............W
W..U...........W
W..............W
W..............W
W.....P........W
W..............W
W..............W
W..............W
W.........U....W
W..............W
W..U...........W
W..............W
W..............W
WWWWWWWWWWWWWWWW